#####B  ###### ######
##### # #############
####  #   ###########
#### ####  ##########
     ##### #  ##  ###
#########  ####  ####
##########  #### # ##
##########  ##### ###
###########    ######
#   #########   #####
#   ########  #######
###  ######  ########
###  ####    ########
###  ##### #  #######
#       ### #  ######
#####  ###     ######
######  ##  #### ####
######   # #### #####
#########        ####
###############    A#